x 2
z 2
12 16
23 10 10 10 10 10 10 10 10 10 10 10 10 10 10 20
11 00 00 00 00 00 00 00 00 00 00 00 00 00 00 11
11 00 00 00 00 00 00 00 00 00 00 00 00 00 00 11
11 00 00 00 00 00 00 00 00 00 00 00 00 00 00 11
21 00 00 00 00 00 00 00 00 00 00 00 00 00 00 11
00 00 00 00 00 00 00 00 00 00 00 00 00 00 00 11
20 00 00 00 00 00 00 00 00 00 00 00 00 00 00 11
11 00 00 00 00 00 00 00 00 00 00 00 00 00 00 11
11 00 00 00 00 00 00 00 00 00 00 00 00 00 00 11
11 00 00 00 00 00 00 00 00 00 00 00 00 00 00 11
11 00 00 00 00 00 00 00 00 00 00 00 00 00 00 11
22 10 10 10 10 10 10 10 10 10 10 10 10 10 10 21
