x 2
z 2
14 14
23 10 10 10 10 10 10 10 10 10 10 10 10 20
11 00 00 00 00 00 00 00 00 00 00 00 00 11
11 00 00 00 00 00 00 00 00 00 00 00 00 11
11 00 00 00 00 00 00 00 00 00 00 00 00 11
11 00 00 00 00 00 00 00 00 00 00 00 00 11
11 00 00 00 00 00 00 00 00 00 00 00 00 11
21 00 00 00 00 00 00 00 00 00 00 00 00 11
00 00 00 00 00 00 00 00 00 00 00 00 00 11
20 00 00 00 00 00 00 00 00 00 00 00 00 11
11 00 00 00 00 00 00 00 00 00 00 00 00 11
11 00 00 00 00 00 00 00 00 00 00 00 00 11
11 00 00 00 00 00 00 00 00 00 00 00 00 22
11 00 00 00 00 00 00 00 00 00 00 00 00 00
22 10 10 10 10 10 10 10 10 10 10 10 10 10
