x 2
z 2
20 10
23 10 10 10 10 10 10 10 10 20
11 00 00 00 00 00 00 00 00 11
11 00 00 00 00 00 00 00 00 11
11 00 00 00 00 00 00 00 00 11
11 00 00 00 00 00 00 00 00 11
11 00 00 00 00 00 00 00 00 11
11 00 00 00 00 00 00 00 00 11
11 00 00 00 00 00 00 00 00 11
11 00 00 00 00 00 00 00 00 11
11 00 00 00 00 00 00 00 00 11
11 00 00 00 00 00 00 00 00 11
11 00 00 00 00 00 00 00 00 11
11 00 00 00 00 00 00 00 00 11
11 00 00 00 00 00 00 00 00 11
11 00 00 00 00 00 00 00 00 11
11 00 00 00 00 00 00 00 00 11
11 00 00 00 00 00 00 00 00 11
11 00 00 00 00 00 00 00 00 11
11 00 00 00 00 00 00 00 00 11
22 20 00 23 10 10 10 10 10 21
