x 2
z 2
8 8
23 10 10 10 10 10 10 20
11 00 00 00 00 00 00 22
11 00 00 00 00 00 00 00
11 00 00 00 00 00 00 23
11 00 00 00 00 00 00 11
11 00 00 00 00 00 00 11
11 00 00 00 00 00 00 11
22 20 00 23 10 10 10 21
