x 2
z 2
12 10
23 10 10 10 21 00 22 10 10 10
11 00 00 00 00 00 00 00 00 00
11 00 00 00 00 00 00 00 00 23
11 00 00 00 00 00 00 00 00 11
11 00 00 00 00 00 00 00 00 11
11 00 00 00 00 00 00 00 00 11
11 00 00 00 00 00 00 00 00 11
11 00 00 00 00 00 00 00 00 11
11 00 00 00 00 00 00 00 00 11
11 00 00 00 00 00 00 00 00 11
11 00 00 00 00 00 00 00 00 11
22 10 10 10 10 10 10 10 10 21
